1 1 1 1 1 1 1 1 1 1
1 1 1 1 1 1 1 1 1 1
2 2 2 3 3 3 3 2 2 2
2 2 2 2 3 3 2 2 2 2
4 4 4 4 2 2 4 4 4 4
5 5 5 5 3 3 5 5 5 5